        #######################
        #SSSSSSS#BSSSS#BSS#SSB#
        #SSSSSSSSSSSSSSSSSSSSS#
        #SSSSSSSSS#####SSSSSSS#
        #SSSSSSSSS#####SSSSSSS#
        #SSSSSSSSS#####SSSSSSS#
        #SSSSSSSSSSSSSSSSSSSSS#
        #SS##########SSSSSSSSS#
        #SS##########SSSSSSSSS#
        #SS##########SSSSSSSSS#
        #SSSSSSSSSSSSSSSSSSSSS#
        #######################
