        ######################
        #SSSSSSSS#SSSSSSSSSBS#
        #SSSSSSSSSSSS##SSSSSS#
        #SSSSSSSS#############
        #SSSSSS###SSSSSSSSSSS#
        #SSSSSS###SSSSSSSSSSS#
        #SSSSSSSS#SSSSSSSSSSS#
        ##S#######SSSSSSSSSSS#
        #SSSSSSSSSSSSSSSSSSSS#
        #SSSSSSSSSSSSSSSSSSSS#
        #SSSSSSSSSSSSSSSSSSSS#
        #SSSSSSSSSSSSSSSSSSSS#
        #SSSSSSSSSSSSSSSSSSSS#
        #SSSSSSSSSSSSSSSSSSSS#
        #SSSSSSSSSSSSSSSSSSSS#
        ######################
