        ######################
        #SSSSSSSS#SSS##SSSSSS#
        #SSSSSSSSSSSS##SSSSSS#
        #SSSSSS###SSSSSSSSS#B#
        #SSSSSS###SSSSSSSSSSS#
        #SSSSSSSSSSSSSSSSSSSS#
        #####SSSSSSSSSSSSSSSS#
        #SSSSSSSSSSSSSSSSSSSS#
        ######################
