        ######################
        #SSSSSSSS#SSS##SSSSBS#
        #SSSSSSSS#SSS##SSSSSS#
        #SSSSSS###SSSSSSSSSSS#
        #SSSSSS###SSSSSSSSSSS#
        #SSSSSSSSSSSSSSSSSSSS#
        #####SSSSSSSSSSSSSSSS#
        #SSSSSSSSSSSSSSSSSSSS#
        ######################
