        ######################
        #SSSSSSSSSSSSSSS#SSBS#
        #SSBSSSSBSSSSSSS#SSSS#
        #########S#######S####
        #SSSSS#SSSSSSSSSSSSSB#
        ##SSS##SSSS###########
        #SSSS#SSSSSSSSSSSSSSS#
        #S##S###########SSSSS#
        #SSSS#SSSSSSSSSSSSSSS#
        #SSSSSSSS###SS####SSS#
        ######################
