        ######################
        #SSSSSSSS#SSSSSSSSSBS#
        #SSSSSSSSSSSS##SSSSSS#
        #SSSSSSSS#############
        ###SSSSSS###SSSSSSSSB#
        ###SSSSSS#S#SSSSSSSSS#
        #SSSSSSSS#SSSSSSSSSSS#
        ##S############SSS####
        #SSSSSSSSSSSSSSSSSSSS#
        #SSSSSSSSSSSSSSSSSSSS#
        #SSSSSSSSSSSSSSSSSSSS#
        ######################
