        ######################
        #SSSSSSSS#SSSSSSSSSBS#
        #SSSSSSSSSSSS##SSSSSS#
        #SSSSSSSS#############
        #SSSSSS###SSSSSSSSSSS#
        #SSSSSS###SSS#SSSSSSS#
        #SSSSSSSS#SSS#SSSSSSS#
        ##S#######SSS####SSSS#
        #SSSSSSSSSSSSSSS#SSSS#
        #SSSSSSSSSSSSSSS##SSS#
        #SSSSSSSSSSSSSSSSSSSS#
        #SSSS#################
        #SSSSSSSSSSSSSSSSSSSS#
        #SSSSSSSSSSSSSSSSSSSS#
        #SSSSSSSSSSSSSSSSSSSS#
        ######################
