        ######################
        #SSSSSSSSSSSSSSSSSSBS#
        #SSBSSSSBSSSSSSSSSSSS#
        #########S#######S####
        #SSSSS#SSSSSSSSSSSSSB#
        ##SSS##SSSS###########
        #SSSS#SSSSSSSSSSSSSSS#
        #S##S###########SSSSS#
        #SSSS#SSSSSSSSSSSSSSS#
        #SSSSSSSSSS####SSSSSS#
        ######################
