        ##########################
        #SSSSSSSSSSSSSSSSSSSSSSSS#
        #SSSSSSSSS############S###
        #SSSSSSSSSSSSSSSSS#SSSSSS#
        #SSSSSSSSSSSSSSSSS#SSSBSS#
        ##########SSSSSSSS#SBSSSS#
        #SSSSSSSSSSSSSSSSS#SSSBSS#
        ##########################
